11111111111111111111111111111
1C000E00000000000000000P00001
11111111111111111111111111111
