111111
1C00C1
1C00C1
101101
1E11P1
111111
