1111111111111
1P000000000C1
1111111111101
1C000000000C1
1011111111111
1C000000000C1
1111111111101
1E000000000C1
1111111111111
