1111111111111
11C1C1C1C1C11
1000000000001
1111111111001
1000000001001
1EP0C0C0C0001
1000000001001
1111111111001
1000000000001
11C1C1C1C1C11
1111111111111
