111111111111111111111
100000000000000000001
100111111101111111001
100100C1C1C1C1C001001
100100110101011001001
1001001M01010M1001001
10M100110101011001M01
100100C001C101C001001
1C0001110101011100001
11111100010100C101001
1C00010001C10001C1001
100M000001010M0111001
1E00010001P1000000C01
111111111111111111111
