1111111111111
11E00000001M1
1111111110101
1C00000000101
1111111110101
1C00000000101
1111111110101
1000000000001
1P00C01000101
1111111100101
1010000001101
1110111100101
10101M00011C1
1110100101001
10101C0101001
1010111101111
1010000101111
1011110100001
1010000101001
10101001000C1
1111111111111
