1111111111111
1EM1000101MC1
100100C001001
1100101010011
1000101010001
1011100001101
1000011100001
1011110111101
1000110110001
1110110110111
1000000000001
100100M001001
1011111111101
1000000000001
111111P111111
10C0000000C01
1C0C00000C0C1
10C0000000C01
11M0001000M11
1C0C0C0C0C0C1
1111111111111
