1111111111111111111111111111111111
1E0100000000000C00000C000010000001
1010010100100000101001000010010101
1010010010101010001001000010011111
1010010010101010001001000010011111
1010010010101010001001000010011111
1010010010101010001001000010011111
1010010010101010001001000010011111
1010010010101010001001000010011111
1010010010101010001001000010011111
1010010010101010001001101111111111
1010010010100010001001000000011111
1000010010101010001001000000011111
1011111111110111111111111110111111
1001111111110111111111111110011111
1100111000000000000011111110011111
1110111000000000000011111110011111
1110001000000000000011111110011111
1111100000000000000011111110011111
1111111000000000000011111110011111
1111111111111111111111111110000111
1111111111111111111111111110010001
1111111111111111111111111111011101
1P0000000C00C00000MM000000000101C1
1111111111111111111111111111111111
